4 2 2 2 2 2 2 2 2 2 2 2 2 2 2 2 2 2 2 2 2 2 2 2 2 2 2 2 2 3
1 4 2 2 2 2 2 2 2 2 2 2 2 2 3 4 2 2 2 2 2 2 2 2 2 2 2 2 3 1
1 1 n . . . . n . . . . . n 1 1 n . . . . . n . . . . n 1 1
1 1 . 4 2 2 3 . 4 2 2 2 3 . 1 1 . 4 2 2 2 3 . 4 2 2 3 . 1 1
1 1 p 1 0 0 1 . 1 0 0 0 1 . 1 1 . 1 0 0 0 1 . 1 0 0 1 p 1 1
1 1 . 5 2 2 6 . 5 2 2 2 6 . 5 6 . 5 2 2 2 6 . 5 2 2 6 . 1 1
1 1 n . . . . n . . n . . n . . n . . n . . n . . . . n 1 1
1 1 . 4 2 2 3 . 4 3 . 4 2 2 2 2 2 2 3 . 4 3 . 4 2 2 3 . 1 1
1 1 . 5 2 2 6 . 1 1 . 5 2 2 3 4 2 2 6 . 1 1 . 5 2 2 6 . 1 1
1 1 n . . . . n 1 1 n . . n 1 1 n . . n 1 1 n . . . . n 1 1
1 5 2 2 2 2 3 . 1 5 2 2 3 0 1 1 0 4 2 2 6 1 . 4 2 2 2 2 6 1
5 2 2 2 2 3 1 . 1 4 2 2 6 0 5 6 0 5 2 2 3 1 . 1 4 2 2 2 2 6
0 0 0 0 0 1 1 . 1 1 N 0 0 N 0 0 N 0 0 N 1 1 . 1 1 0 0 0 0 0
2 2 2 2 2 6 1 . 1 1 0 4 2 2 7 7 2 2 3 0 1 1 . 1 5 2 2 2 2 2
2 2 2 2 2 2 6 . 5 6 0 1 0 0 0 0 0 0 1 0 5 6 . 5 2 2 2 2 2 2
N 0 0 0 0 0 0 n 0 0 N 1 0 0 0 0 0 0 1 N 0 0 n 0 0 0 0 0 0 N
2 2 2 2 2 2 3 . 4 3 0 1 0 0 0 0 0 0 1 0 4 3 . 4 2 2 2 2 2 2
2 2 2 2 2 3 1 . 1 1 0 5 2 2 2 2 2 2 6 0 1 1 . 1 4 2 2 2 2 2
0 0 0 0 0 1 1 . 1 1 N 0 0 0 0 0 0 0 0 N 1 1 . 1 1 0 0 0 0 0
4 2 2 2 2 6 1 . 1 1 0 4 2 2 2 2 2 2 3 0 1 1 . 1 5 2 2 2 2 3
1 4 2 2 2 2 6 . 5 6 0 5 2 2 3 4 2 2 6 0 5 6 . 5 2 2 2 2 3 1
1 1 n . . . . n . . n . . n 1 1 n . . n . . n . . . . n 1 1
1 1 . 4 2 2 3 . 4 2 2 2 3 . 1 1 . 4 2 2 2 3 . 4 2 2 3 . 1 1
1 1 . 5 2 3 1 . 5 2 2 2 6 . 5 6 . 5 2 2 2 6 . 1 4 2 6 . 1 1
1 1 P . n 1 1 n . . n . . n . . n . . n . . n 1 1 n . P 1 1
1 5 2 3 . 1 1 . 4 3 . 4 2 2 2 2 2 2 3 . 4 3 . 1 1 . 4 2 6 1
1 4 2 6 . 5 6 . 1 1 . 5 2 2 3 4 2 2 6 . 1 1 . 5 6 . 5 2 3 1
1 1 n . n . . n 1 1 n . . n 1 1 n . . n 1 1 n . . n . n 1 1
1 1 . 4 2 2 2 2 6 5 2 2 3 . 1 1 . 4 2 2 6 5 2 2 2 2 3 . 1 1
1 1 . 5 2 2 2 2 2 2 2 2 6 . 5 6 . 5 2 2 2 2 2 2 2 2 6 . 1 1
1 1 n . . . . . . . . . . n . . n . . . . . . . . . . n 1 1
1 5 2 2 2 2 2 2 2 2 2 2 2 2 2 2 2 2 2 2 2 2 2 2 2 2 2 2 6 1
5 2 2 2 2 2 2 2 2 2 2 2 2 2 2 2 2 2 2 2 2 2 2 2 2 2 2 2 2 6 
